NO ./textures/wolfenstein/blue_stone.xpm
SO ./textures/wolfenstein/color_stone.xpm
WE ./textures/wolfenstein/eagle.xpm
EA ./textures/wolfenstein/grey_stone.xpm

F 255,255,0
C 128,0,128

           11111111111       
        11100000000000111      
      1110000000000000000111    
    11100000000111100000000111
   1100000001110000111000000011
  110000001100000000001100000011
 11000000100000000000000100000011
11000000100000000S0000000100000011
1100000100000000000000000010000011
1100000100000001111100000010000011
 11000010000111111111110001000011
  110001100000000000000001100011
   1100011000000000000001100011
    11000110000000000001100011
     110001100000000001100011
      1100011111011111100011
       11100000000000000111
        11111111111111111

