C       2,89,5
NO ./textures/wolfenstein/blue_stone.xpm


SO ./textures/wolfenstein/blue_stone.xpm
 








EA ./textures/wolfenstein/grey_stone.xpm



WE ./textures/wolfenstein/eagle.xpm


F 5,0,7




        1111111111111111111111111
        1000000000110000000000001
        1011000001110000000000001
        1001000000000000000000001
111111111011000001110000000000001
100000000011000001110111111111111
11111111111101111111111111111
           101
11111111111101111111111111111
11110111111100011100000010001
111101111 1111011101010010001
11000000110101011100000010001
10000000000000001100000010001
10000000000000001101010010001
11000001110101011111011110N0111
11110111 1110101 101111010001
11111111 1111111 111111111111
